{
	"clearcolor": "0x080808",
	"lights": [
		{ "type": "DirectionalLight", "strength": 0, "position": { "x": 1, "y": 0.8, "z": 0.5 } }
	],
	"_commentLights": [
		{ "type": "PointLight", "color": "0xFFFFFF", "strength": 0.8, "distance": 10, "position": { "x": 3, "y": 3, "z": 3 } },
		{ "type": "PointLight", "color": "0xFFFFFF", "strength": 0.8, "distance": 10, "position": { "x": 7, "y": 3, "z": 12 } },
		{ "type": "HemisphereLight", "strength": 0.05, "ground": "0xFFFFFF", "sky": "0xFFFFFF" }
	],
	"cameraSpeed": 4,
	"cameras": [
		{ "position": { "x": 2, "y": 8, "z": 5 }, "rotation": { "x": -1.57, "y": 0, "z": 0 }, "speed": 4 },
		{ "position": { "x": 2, "y": 1, "z": 9 }, "rotation": { "x": 0, "y": 0, "z": 0 }, "speed": 6 },
		{ "position": { "x": 6, "y": 1, "z": 5 }, "rotation": { "x": 0, "y": 1.57, "z": 0 }, "speed": 6 }
	],
	"map": [
			[0,0,0,0,0,0,0,0,0,0,0,0,0],
			[0,0,0,0,0,0,0,0,0,0,0,0,0],
			[0,0,0,0,3,3,3,0,0,0,0,0,0],
			[0,0,3,3,1,1,1,3,0,0,0,0,0],
			[0,3,1,1,1,4,1,1,3,0,0,0,0],
			[3,1,1,1,1,1,1,1,1,3,0,0,0],
			[3,1,5,1,1,1,1,1,1,5,3,0,0],
			[3,1,1,1,1,1,1,1,1,1,3,0,0],
			[0,3,1,1,1,1,1,1,1,1,3,0,0],
			[0,0,3,1,1,1,1,5,1,3,0,0,0],
			[0,0,0,3,4,1,1,1,3,0,0,0,0],
			[0,0,0,0,3,1,1,3,0,0,0,0,0],
			[0,0,0,0,3,1,1,3,0,0,0,0,0],
			[0,0,0,0,3,1,1,1,3,0,0,0,0],
			[0,0,0,0,0,3,1,1,1,3,0,0,0],
			[0,0,0,0,0,0,3,1,1,3,0,0,0],
			[0,0,0,0,0,0,3,1,1,4,3,0,0],
			[0,0,0,0,0,0,3,1,1,1,3,0,0],
			[0,0,0,0,0,0,3,1,1,1,3,0,0],
			[0,0,0,0,0,3,5,1,1,3,0,0,0],
			[0,0,0,0,0,0,3,1,1,3,0,0,0],
			[0,0,0,0,0,0,3,1,1,1,3,0,0],
			[0,0,0,0,0,0,3,1,1,5,3,0,0],
			[0,0,0,0,0,0,3,1,1,3,0,0,0],
			[0,0,0,0,0,3,1,1,5,3,0,0,0],
			[0,0,0,0,0,3,1,1,3,0,0,0,0],
			[0,0,0,0,3,1,1,1,3,0,0,0,0],
			[0,0,0,0,3,1,1,1,1,3,0,0,0],
			[0,0,0,0,3,1,1,1,1,1,3,0,0],
			[0,0,0,0,3,1,1,5,1,1,3,0,0],
			[0,0,0,0,0,3,1,1,1,3,0,0,0],
			[0,0,0,0,0,0,3,3,3,0,0,0,0],
			[0,0,0,0,0,0,0,0,0,0,0,0,0]
		]
}
