{
	"clearcolor": "0x11111111", 
	"text": {
		"color": "0x6c66a1", 
		"fontFile": "build/Cinzel_Bold.json"
	}, 
	"lights": [
		{ "type": "DirectionalLight",  "strength": 0.4,  "position": { "x": 1,  "y": 0.8,  "z": 0.5 } },
		{ "type": "HemisphereLight",  "strength": 0.15,  "ground": "0xFFFFFF",  "sky": "0xFFFFFF" }
	], 
	"_commentLights": [
		{ "type": "PointLight",  "color": "0xFFFFFF",  "strength": 0.8,  "distance": 10,  "position": { "x": 3,  "y": 3,  "z": 3 } }, 
		{ "type": "PointLight",  "color": "0xFFFFFF",  "strength": 0.8,  "distance": 10,  "position": { "x": 7,  "y": 3,  "z": 12 } }, 
		{ "type": "HemisphereLight",  "strength": 0.05,  "ground": "0xFFFFFF",  "sky": "0xFFFFFF" }
	], 
	"cameraSpeed": 4, 
	"cameras": [
		{ "position": { "x": 2,  "y": 8,  "z": 5 },  "rotation": { "x": -1.57,  "y": 0,  "z": 0 },  "speed": 4 }, 
		{ "position": { "x": 2,  "y": 1,  "z": 9 },  "rotation": { "x": 0,  "y": 0,  "z": 0 },  "speed": 6 }, 
		{ "position": { "x": 6,  "y": 1,  "z": 5 },  "rotation": { "x": 0,  "y": 1.57,  "z": 0 },  "speed": 6 }
	], 
	"audio": {
		"gun": "audio/gun9mm.wav", 
		"dog": "audio/doghowling.wav", 
		"dance": "audio/DuckSauce-BarbraStreisandShort.mp3", 
		"randomHorn": "audio/randoms/air-horn-short.mp3", 
		"randomGong": "audio/randoms/chinese-gong-daniel_simon.mp3", 
		"randomDog": "audio/randoms/doberman-pincher-short.mp3", 
		"randomGibbon": "audio/randoms/gibbon-monkey-daniel_simon.mp3", 
		"randomSuspence": "audio/randoms/gibbon-monkey-daniel_simon.mp3", 
		"randomRooster": "audio/randoms/RoosterCrow.mp3"
	}, 
	"map": [ 
			[0, 0, 0, 0, 0, 0, 0, 0, 0, 0, 0, 0, 0, 0, 3, 3, 3, 3, 3, 3, 3, 3, 3, 0, 0, 0, 0, 0, 0, 0, 3, 3, 3, 3, 3, 3, 3],
			[0, 0, 0, 0, 0, 0, 0, 0, 0, 0, 0, 0, 0, 0, 3, 6, 1, 1, 1, 1, 1, 6, 3, 3, 3, 3, 3, 3, 3, 3, 1, 6, 1, 1, 1, 6, 1, 3],
			[0, 0, 0, 0, 0, 0, 0, 0, 0, 0, 0, 0, 0, 0, 3, 1, 1, 1, 1, 1, 1, 1, 3, 4, 1, 1, 1, 1, 1, 4, 1, 1, 1, 1, 1, 1, 1, 1, 3],
			[0, 0, 0, 0, 0, 0, 0, 0, 0, 0, 0, 0, 0, 0, 3, 1, 1, 1, 1, 1, 1, 1, 7, 1, 1, 1, 1, 1, 1, 1, 1, 1, 1, 1, 1, 1, 1, 1, 3],
			[0, 0, 0, 0, 0, 0, 0, 0, 0, 0, 0, 0, 0, 0, 3, 1, 1, 1,12, 1, 1, 1, 3, 4, 1, 1, 1, 1, 1, 4, 1, 1, 1, 1, 1, 1, 1, 1, 3],
			[0, 0, 0, 0, 0, 0, 0, 0, 0, 0, 0, 0, 0, 0, 3, 1, 1, 1, 1, 1, 1, 1, 3, 3, 3, 3, 3, 3, 3, 3, 1, 1, 1, 1, 1, 1, 1, 3],
			[0, 0, 0, 0, 0, 0, 0, 0, 0, 0, 0, 0, 0, 0, 3, 6, 1, 1, 1, 1, 1, 6, 3, 0, 0, 0, 0, 0, 0, 0, 3, 3, 3, 3, 3, 3, 3], 
			[0, 0, 0, 0, 0, 0, 0, 0, 0, 0, 0, 0, 0, 0, 0, 3, 1, 1, 1, 1, 1, 3], 
			[0, 0, 0, 0, 0, 0, 0, 0, 0, 0, 0, 0, 0, 0, 0, 0,10,11,11,11,10], 
			[0, 0, 0, 0, 0, 0, 0, 0, 0, 0, 0, 0, 0, 0, 0, 3, 1, 1, 1, 1, 1, 3], 
			[0, 0, 0, 0, 0, 0, 0, 0, 0, 0, 0, 0, 0, 0, 3, 1, 6, 1, 1, 1, 6, 1, 3], 
			[0, 0, 0, 0, 0, 0, 0, 0, 0, 0, 0, 0, 0, 0, 3, 1, 1, 1, 1, 1, 1, 1, 3], 
			[0, 0, 0, 0, 0, 0, 0, 0, 0, 0, 0, 0, 0, 0, 3, 1, 1, 1, 1, 1, 1, 1, 3], 
			[0, 0, 0, 0, 0, 0, 0, 0, 0, 0, 0, 0, 0, 0, 0, 3, 1, 1, 1, 1, 1, 3], 
			[0, 0, 0, 0, 0, 0, 0, 0, 0, 0, 0, 0, 0, 0, 0, 0, 3, 3, 1, 1, 1, 3, 3, 3], 
			[0, 0, 0, 0, 0, 0, 0, 0, 0, 0, 0, 0, 0, 0, 0, 0, 0, 3, 1, 5, 3, 1, 5, 3], 
			[0, 0, 0, 0, 0, 0, 0, 0, 0, 0, 0, 0, 3, 3, 0, 0, 0, 3, 1, 3, 1,12, 1, 3], 
			[0, 0, 0, 0, 0, 0, 0, 0, 0, 0, 0, 3, 1, 1, 3, 0, 0, 3, 1, 1, 1, 1, 1, 3], 
			[0, 0, 0, 0, 0, 0, 0, 0, 0, 0, 3, 1, 1, 1, 1, 3, 3, 1, 1, 1, 1, 1, 1, 3], 
			[0, 0, 0, 0, 0, 0, 0, 0, 0, 3, 1, 1, 1, 1, 1, 1, 1, 1, 1, 1, 1, 1, 3], 
			[0, 0, 0, 0, 0, 0, 0, 0, 0, 3, 1, 1, 1, 1, 1, 3, 5, 1, 1, 1, 3, 3],
			[0, 0, 0, 0, 0, 0, 0, 0, 0, 3, 1, 1, 1, 1, 3, 0, 3, 3, 3, 3], 
			[0, 0, 0, 0, 0, 0, 0, 0, 0, 0, 3, 1, 5, 1, 3], 
			[0, 0, 0, 0, 0, 0, 0, 0, 0, 0, 3, 1, 1, 1, 3], 
			[3, 3, 3, 3, 3, 3, 3, 3, 3, 3,10,11,11,11,10, 3, 3, 3, 3, 3, 3, 3, 3, 3, 3], 
			[3, 1, 1, 1, 1, 1, 1, 3, 1, 1, 1, 1, 1, 1, 1, 1, 1, 3, 1, 1, 1, 1, 1, 1, 3], 
			[3, 1, 1, 1, 1, 1, 1, 3, 1, 1, 6, 1, 1, 1, 6, 1, 1, 3, 1, 1, 1, 1, 1, 1, 3], 
			[3, 1, 1, 1, 1, 1, 1, 3, 1, 1, 1, 1, 1, 1, 1, 1, 1, 3, 1, 1, 1, 1, 1, 1, 3], 
			[3, 1, 1, 4, 1, 4, 1, 3, 1, 1, 1, 1, 1, 1, 1, 1, 1, 3, 1, 4, 1, 4, 1, 1, 3], 
			[3, 3, 3, 3, 7, 3, 3, 3, 1, 1, 1, 1, 1, 1, 1, 1, 1, 3, 3, 3, 7, 3, 3, 3, 3], 
			[3, 1, 1, 1, 1, 1, 1, 1, 1, 1, 1, 1, 1, 1, 1, 1, 1, 1, 1, 1, 1, 1, 1, 1, 3], 
			[3, 1, 1, 1, 1, 1, 1, 1, 1, 1, 1, 1, 1, 1, 1, 1, 1, 1, 1, 1, 1, 1, 1, 1, 3], 
			[3, 1, 1, 1, 1, 1, 1, 1, 1, 1, 1, 1, 1, 1, 1, 1, 1, 1, 1, 1, 1, 1, 1, 1, 3], 
			[3, 1, 1, 1, 1, 1, 1, 1, 1, 1, 1, 1, 1, 1, 1, 1, 1, 1, 1, 1, 1, 1, 1, 1, 3], 
			[3, 3, 3, 3, 7, 3, 3, 3, 3, 3, 3, 3, 7, 3, 3, 3, 3, 3, 3, 3, 7, 3, 3, 3, 3], 
			[3, 1, 1, 4, 1, 4, 1, 1, 3, 1, 1, 4, 1, 4, 1, 1, 3, 1, 1, 4, 1, 4, 1, 1, 3], 
			[3, 1, 1, 1, 1, 1, 1, 1, 3, 1, 1, 1, 1, 1, 1, 1, 3, 1, 1, 1,12, 1, 1, 1, 3], 
			[3, 1, 1, 1, 1, 1, 1, 1, 3, 1, 1, 1, 1, 1, 1, 1, 3, 1, 1, 1, 1, 1, 1, 1, 3], 
			[3, 1, 1, 1, 1, 1, 1, 1, 3, 1, 1, 1, 1, 1, 1, 1, 3, 1, 1, 1, 1, 1, 1, 1, 3], 
			[3, 3, 3, 3, 8, 8, 3, 3, 3, 3, 3, 3, 3, 3, 3, 3, 3, 3, 3, 3, 3, 3, 3, 3, 3], 
			[0, 3, 1, 1, 1, 1, 1, 1, 1, 3, 0, 0, 0], 
			[0, 0, 3, 1, 1, 1, 1, 1, 1, 3, 0, 0, 0], 
			[0, 0, 0, 3, 1, 1, 1, 1, 3, 0, 0, 0, 0], 
			[0, 0, 0, 0, 3, 1, 1, 3, 0, 0, 0, 0, 0], 
			[0, 0, 0, 0, 3, 1, 5, 3, 0, 0, 0, 0, 0], 
			[0, 0, 0, 0, 3, 1, 1, 1, 3, 0, 0, 0, 0], 
			[0, 0, 0, 0, 0, 3, 1, 1, 1, 3, 0, 0, 0], 
			[0, 0, 0, 0, 0, 0, 3, 1, 1, 3, 0, 0, 0], 
			[0, 0, 0, 0, 0, 0, 3, 1, 1, 5, 3, 0, 0], 
			[0, 0, 0, 0, 0, 0, 3, 1, 1, 1, 3, 0, 0], 
			[0, 0, 0, 0, 0, 0, 3, 1, 1, 1, 3, 0, 0], 
			[0, 0, 0, 0, 0, 3, 1, 1, 1, 3, 0, 0, 0], 
			[0, 0, 0, 0, 0, 3, 1, 1, 1, 3, 0, 0, 0], 
			[0, 0, 0, 0, 0, 3, 5, 1, 1, 1, 3, 0, 0], 
			[0, 0, 0, 0, 0, 0, 3, 1, 1, 1, 3, 0, 0], 
			[0, 0, 0, 0, 0, 0, 3, 1, 1, 3, 0, 0, 0], 
			[0, 0, 0, 0, 0, 3, 1, 1, 1, 3, 0, 0, 0], 
			[0, 0, 0, 0, 0, 3, 1, 1, 3, 0, 0, 0, 0], 
			[0, 0, 0, 0, 3, 1, 1, 1, 3, 0, 0, 0, 0], 
			[0, 0, 0, 0, 3, 1, 1, 1, 1, 3, 0, 0, 0], 
			[0, 0, 0, 0, 3, 1, 1, 1, 1, 1, 3, 0, 0], 
			[0, 0, 0, 0, 3, 1, 1, 5, 1, 1, 3, 0, 0], 
			[0, 0, 0, 0, 0, 3, 1, 1, 1, 3, 0, 0, 0], 
			[0, 0, 0, 0, 0, 0, 3, 3, 3, 0, 0, 0, 0], 
			[0, 0, 0, 0, 0, 0, 0, 0, 0, 0, 0, 0, 0]
		]
}
